No,氏名,国語,数学,英語,合計点
1,テスト1,63,69,87,219
2,テスト2,77,69,85,231
3,テスト3,80,91,92,263
4,テスト4,79,84,70,233
5,テスト5,69,72,80,221
6,テスト6,88,85,75,248
7,テスト7,66,76,80,222
8,テスト8,61,70,69,200
9,テスト9,90,88,94,272
10,テスト10,60,56,58,174
